# ddddddwdddddddddssssaaasaaaaaaasssdddddddsssddssaaaaaaaaaaaaaawwwwwwwww

# ************************
# **********..........****
# ****S......********.****
# *******************.****
# *******************.****
# ****E***********....****
# ****.****........*******
# ****.****.**************
# ****.****.**************
# ****.****........*******
# ****.***********.*******
# ****.***********.*******
# ****.***********...*****
# ****.*************.*****
# ****...............*****
# ************************
